TILEMAP
250 24 							-- Size of tile map in tiles
16 16 							-- Tile size & block size
images/tilesheet.png 	-- Tilesheet
8 8 								-- Number of tiles in tilesheet
4444444444444444444444444444444444444444444444444444444444444444444444444444444444444444444444444444444444444444444444444444444444444444444444444444444444444444444444444444444444444444444444444444444444444444444444444444444444444444444444444444444444
4                                                                                                                                                                                                                                                        4
4                                                                                                                                                                                                                                                        4
4                                                                                                                                                                                                                                                        4
4                                                                                                                                                                                                                                                        4
4                                                                                                                                                                                                                                                        4
4                                                                                                                                                                                                                                                        4
4                                                                                                                                                                                                                                                        4
4                                                                                                                                                                                                                                                        4
4                                                                                                                                                                                          3333   333    333    333            ;<                        4
4                        =                               = =                                                                             ====                                                                                IJKD                        4
4                                                                                                                                                                                                                            QRSD                        4
4                                                                                                                                                                                                                          IJJJKD                        4
4                                                                                                                                                                                           ;<                             QRRRSD                        4
4                        =                               = =                     ====                      ;<            ;<            ===33===                                             CD     =      =      =       IJJJJJKD   BB                   4
4                   ;<                                                                        B            CD            CD                                                 B               CD                           QRRRRRSD                        4
4                   CD                                                                        B            CD      IJJJJJKD                           ;<                    B            IJJKD                         IJJJJJJJKD                        4
4                   CD                                                                        B            CD      QRRRRRSD                           CD                    B            QRRSD                         QRRRRRRRSD        2               4
11119111991111111:111:111:1111:11  111119111:1::111111999911::111111    11111:111991111:1111111111111111:1999991111111111111:91:11111111:1  1111:1111111111191   1:1  1111119  1111:1111111111111991111111111:111111111111191:1111      111:11111::1111111
1111999:::99911111::::1111111::11  11191:11::11119:111199111::111111    9911111:1111:11111119999911111111::1111911111111111::199911111::11  :111:::19999111991   :11  199:111  111119:1199:91199911111111:::::11191199119911:111:1      111::11::119111111
4                                                                                                                                                                                                                                                        4
4                                                                                                                                                                                                                                                        4
4                                                                                                                                                                                                                                                        4
4444444444444444444444444444444444444444444444444444444444444444444444444444444444444444444444444444444444444444444444444444444444444444444444444444444444444444444444444444444444444444444444444444444444444444444444444444444444444444444444444444444444