TILEMAP
250 20							-- Size of tile map in tiles
16 16 							-- Tile size & block size
images/tilesheet.png 	-- Tilesheet
8 8 								-- Number of tiles in tilesheet
                                                                                                                                                                                                                                                          
                                                                                                                                                                                                                                                          
                                                                                                                                                                                                                                                          
                                                                                                                                                                                                                                                          
0000000000000000000000000000000000000000000000000000000000000000000000000000000000000000000000000000000000000000000000000000000000000000000000000000000000000000000000000000000000000000000000000000000000000000000000000000000000000000000000000000000000
00000000000000000000000000000000000000000000000000000000000000000000000000000000000000000000000000000000000000000000YZ[0000000000000000000000000000000000000000000000000000000000000000000000000YZ[00000000000000000YZZ[00000000000000000000000000Y[000000
0000000000000000000000000000000000000000000000000000000000000000000000000000000000000000YZZZZZ[0000000000000000000000000000000000YZZZZZ[00000000000000YZZ[000000000000YZZZ[000000000000000000000000000000000000000000000000000YZZZ[00000000000000Y\d000000
000000000YZZ[00000000000000000000000000000000YZZ[0000000000000000000000000000000000000000000000000000000000000000000000000000000000000000000000000000Yabbc00000000000Yabbbc[0000000YZZZ[000000000000000000000000000000000YZZ[0000000000000000000Y\d0000000
00000000000000000000000000000YZZZ[000000000YZ[00000000000000000000000YZ[0000000000000000000000000000000000YZ[000000000000000000000000000000000000Y[0Yabbbbc[000000000000000000000000000000000000000000000YZ[0000000000000000000000000000L000000Y\d40000000
0000000000000000000000000000Yabbbc[000000000000000000000000000000000Yabc[000000000F000000F000000000000000Yabc[0000000000000000000F0000000E000000Yac[000000000000000000000000000000000000000000000000000000000000000000000000000000000000T000000???00000000
00000000000000000000000000000000000000000000000000000000070000000000000000000000000000000000000000000000000000000000000000000000000000000000000000000000000000000000000000000000006778000F0000000000000000000000000000000000F00000000000T000000???00000000
000000000000000000000000000000000000000000000000000000000?00000Y[00000000000000000000000000000000000000000400000000000000000000067700000000000000000000000000000000000000000000000>??@00022220000000000000000000000000000000000000000000T000000???00000000
000000000000000000000000000000000004444400000000000000007?7000Y\d000000000000000000000000000000000000000004000000000000000000000>??00000000000000000000000000000000000000000000000>??@00000000000006780000000000000000000000000000000000T000000???00000000
00000000000000000000000000000000000674440000000000000000???00Y\d0000000000000000000700444000000000000000004000000000000000000000>??7800000000000000000000000000000000000000000Y[00>??@0000000000040>?@0000000000000000000E00000000000000T000000???00000000
00000000000000000000000000000000000>?4400000000000000004???400000000000000000000000?70678000000000000004404000000000000000000000>???@0000000000000000000000000000000000000000Y\d00>?220200000000040>??0000000000000000000000000000000000T000000???00000000
00006780000000000000000000000000000>??@00000000000000006???800000000000000000000000??8>?@000000000000004444444400000000000000000>???@000000000000000000000000000000000000000Y\d000>??@0000000000040>??@000000000000000000000000000000000T000067???78000000
0000>?@0000000000000000000000000000>??@0000000000000000>???@00000000000000000000006??@>?@000000000000006784444400000000000000000>???@00000000000000000000000F000000000000000000000>??@0000000000000>???@00000000000000000000000000000000T0000>?????@000000
0000>?@0000000000000000000000000000>??@00000000F4000000>???@F00000044000000000000F>??@>?@F0000000000000>?@F4444000000F0000000000>???@E000000000000E00000000F00000000000F000000E000>??@000000000000F>???@F000000000EF0000000000000000000020000>?????@000000
0000000000000000000000000000000000000000000000000000000000000000000000000000000000000000000000000000000000000000000000000000000000000000000000000000000000000000000000000000000000000000000000000000000000000000000000000000000000000000000000000000000000
0000000000000000000000000000000000000000000000000000000000000000000000000000000000000000000000000000000000000000000000000000000000000000000000000000000000000000000000000000000000000000000000000000000000000000000000000000000000000000000000000000000000