TILEMAP
64 28 							-- Size of tile map in tiles
16 32 							-- Tile size & block size
images/blocks.png 	-- Tilesheet
2 2 								-- Number of tiles in tilesheet
1111111111111111111111111111111111111111111111111111111111111111
11                                                            11
11                                                            11
11                                                            11
11                                                            11
11                                                            11
11                                                            11
11                                                            11
11                                                            11
11                                                            11
11                                                            11
11                                                            11
11                                                            11
11                                                            11
11                                                            11
11                                                            11
11                                                            11
11                                                            11
11                                                            11
11                        1                                   11
11   111                  11111                               11
11                        1                                   11
11               111      1                                   11
11                        1                                   11
11        111             1                                   11
11                        1                                   11
11                        1                                   11
1111111111111111111111111111111111111111111111111111111111111111